0000000011
0100101110
0111011010
1111101010
0010111100
0010010011
0111110100
0111101110
0011000000
0000000000